  ####
###  ##
#   $ #
# #.#@#
# #$ .#
#  .$ #
##   ##
 #####