##########
#--------#
#---..-$-#
#---$----#
#--------#
#----@---#
#--$-----#
#-----.--#
#--------#
##########